$$$ exec p1 : [./sreijola.filler]
Plateau 10 17:
    01234567890123456
000 OO...............
001 OO...............
002 .................
003 .................
004 .................
005 .................
006 .................
007 .................
008 .................
009 .................
010 ..............XXX
011 ..............XXX
012 ..............XXX
013 .................
014 ................O
Piece 3 6:
......
**.**.
.****.
